cobbler	a person whose job is mending shoes.	
perish	die, especially in a violent or sudden way.	
eradicate	destroy completely; put an end to.	
atrophied	(of body tissue or an organ) waste away, especially as a result of the degeneration of cells, or become vestigial during evolution.	
craftsmanship	skill in a particular craft.	
catapult	1. a forked stick with an elastic band fastened to the two prongs, used by children for shooting small stones.<div>2.&nbsp;a military machine worked by a lever and ropes for hurling large stones or other missiles.</div>	
usher	show or guide (someone) somewhere.	
temple	a building devoted to the worship of a god or gods.	
hinge	a movable joint or mechanism on which a door, gate, or lid swings as it opens and closes or which connects linked objects.	
paralyzed	cause (a person or part of the body) to become partly or wholly incapable of movement.	
embrace	hold (someone) closely in one's arms, especially as a sign of affection.	
authenticity	the quality of being authentic.	
scoliosis	<div>abnormal lateral curvature of the spine.</div>	
brace	a device fitted to something, in particular a weak or injured part of the body, to give support.	
amputee	a person who has had a limb amputated.	
audacious	&nbsp;showing a willingness to take surprisingly bold risks.	
absinthe	a potent green aniseed-flavoured liqueur, originally made with the shrub wormwood.	
rudimentary	involving or limited to basic principles.	
abundance	a very large quantity of something.	
haptic	relating to the sense of touch, in particular relating to the perception and manipulation of objects using the senses of touch and proprioception.	
perceptual	relating to the ability to interpret or become aware of something through the senses.	
counterfeiting / counterfeit	imitate fraudulently.	
ubiquitous	present, appearing, or found everywhere.	
cleat	a T-shaped piece of metal or wood on a boat or ship, to which ropes are attached.	